10 10 2 15
## #  @  #
#      / #
# D       
@   +  @ #
#        #
  !   +  #
#         
#    +   #
# @      #
# #### ###